0101 0110 0111 0110 0110 0110 0110 0110 0110 0011
1001 0000 1001 0101 0111 0111 0111 0111 0111 1010
1101 0110 1011 1001 1001 1001 1001 1001 1001 0001
1001 0001 1001 1001 1000 1000 1000 1000 1000 1001
1001 1001 1001 1100 0110 0110 0110 0110 0110 1011
1001 1001 1001 0101 0110 0110 0110 0110 0110 1010
1001 1001 1001 1101 0110 0110 0110 0110 0110 0011
1001 1001 1001 1000 0100 0110 0110 0110 0011 1001
1001 1001 1100 0110 0110 0110 0110 0110 1010 1001
1100 1110 0110 0110 0110 0110 0110 0110 0010 1001