0101 0110 0111 0111 0111 0111 0111 0111 0111 0011
1001 0001 1001 1101 1110 1110 1011 1101 1111 1011
1001 1001 1001 1101 0110 0110 1011 1101 1111 1011
1001 1001 1001 1101 0110 0110 1011 1101 1111 1011
1001 1001 1001 1101 0110 0110 1011 1101 1111 1011
1001 1001 1001 1100 0110 0110 1010 1101 1111 1011
1001 1001 1100 0110 0110 0110 0011 1101 1111 1011
1101 1111 0110 0110 0110 0110 1011 1100 1010 1001
1101 1111 0111 0111 0111 0111 1111 0111 0011 1001
1100 1110 1110 1110 1110 1110 1110 1110 1010 1000