0100 0011 0000 0000 0000 0000 0000 0000 0000 0000
0000 1100 0111 0010 0000 0000 0000 0000 0000 0000
0000 0000 1001 0000 0000 0000 0000 0000 0000 0000
0000 0000 1001 0000 0000 0000 0000 0000 0000 0000
0101 0110 1111 0010 0000 0000 0000 0000 0000 0000
1001 0000 1000 0000 0000 0000 0101 0011 0000 0000
1100 0110 0111 0010 0000 0000 1001 1001 0000 0000
0000 0000 1001 0000 0101 0110 1010 1001 0000 0000
0000 0100 1110 0110 1010 0000 0000 1001 0000 0000
0000 0000 0000 0000 0000 0000 0000 1100 0110 0010